





*****                                                
*****                                   *****
*****            ***                    *****
*****            **       **
*****                     **
**********************************   ***     ****  ********  ******  **********
**********************************   ***     *****  ******           **********
**********************************   ***     ******  ****  ********************
**********************************   ******               *********************
**********************************   ******************************************
