















*      *        *          *     *                              *        *
*      *    *   *         **     **                   *         *       **   
*     ***   **  *    *   ***    ****   *              **    **  *  *    ***   *
**   ****** *** *    *   ***** ****** **              **** **** * **   ****   *
**   ********** * *  * * ****************   *   *     ********* * **   ***** **
**   ********** * *  * * ****************   *   *    *************** * ********
**** **************  * ******************** *  **    *************** * ********
******************* ************************* *****  *************** **********
********************************************* *********************************
*******************************************************************************
*******************************************************************************
*******************************************************************************
*******************************************************************************
*******************************************************************************
*******************************************************************************
*******************************************************************************
