



                                                  *** *  *   *    *   *
                                              **     *                     *
                                         ***          *                    *
                           ************                *                   *
                        *                ***            *
                    *                                    *                     *
                   *                                      *               *    *          *
                *                                          *         *    *    *      *   *
   @        *                                               *        *    *    *    *     *
******** *                                                       *   *    *    *  * *     *
**********                                       *****************   *    *    *    *     *       *************
**********                                       *****************   *    *    *    *     *      **************
