















#      #        #          #     #                              #        #
#      #    #   #         ##     ##                   #         #       ##
#     ###   ##  #    #   ###    ####   #              ##    ##  #  #    ###   #
##   ###### ### #    #   ##### ###### ##              #### #### # ##   ####   #
##   ########## # #  # # ################   #   #     ######### # ##   ##### ##
##   ########## # #  # # ################   #   #    ############### # ########
#### ##############  # #################### #  ##    ############### # ########
################### ######################### #####  ############### ##########
############################################# #################################
###############################################################################
###############################################################################
###############################################################################
###############################################################################
###############################################################################
###############################################################################
###############################################################################
