

                                 *
         @
                             *
 
*****                    *                            
*****                                   *****
*****            *****                    *****
*****            ** **    **
*****                     **                                                  *
**********************************   ***     ****  ********  ******  **********
********    **********************   ***     *****  ******           **********
**********************************   ***     ******  ****  ********************
**********************************   ******               *********************
**********************************   ******************************************
