


                                                   @
                                                  ***
                                              **     *
                                         ***          *
                           ************                *
                       *                 ***            *
                    *                                    *                     *    *
                 *                                        *               *    *    *     *
              *                                            *         *    *    *    *     *
           *                                                *        *    *    *    *     *
                                                                 *   *    *    *    *     *
*********                                        *****************   *    *    *    *     *       *************
*********                                        *****************   *    *    *    *     *      **************
