


                                *  *  *

                             *
*****
*****       @            *              *****
*****            *****                    *****
*****            ** **    **
*****                     **                                                  *
********    **********************   ***     ****  ********  ******  **********
********    **********************   ***     *****  ******           **********
**********  **********************   ***     ******  ****  ********************
*********** **********************   ******               *********************
**********************************   ******************************************
